26 26 26 26 26 26 26 41 41 41
26 41 41 41 41 41 26 41 41 41
26 41 41 41 41 41 26 26 26 26
26 41 41 41 41 41 41 41 41 41
26 41 41 41 41 41 41 41 41 41
26 41 41 41 41 41 26 26 26 26
26 26 26 26 26 26 26 41 41 41