41 41 41 41 41 41 41 41 41 41
41 38 38 38 38 38 41 41 41 41
41 38 38 38 38 38 38 38 38 38
41 38 38 38 38 38 38 38 38 38
41 38 38 38 38 38 38 38 38 38
41 38 38 38 38 38 41 41 41 41
41 41 41 41 41 41 41 41 41 41